[Main]
Name = Test Level
Start = 7, 4

[Objects]
Door = 11, 4
	9, 7
	13, 1
	25, 4

[Terrain]

terrain = 
           ######          
           #....#          
###########################
#..####....#.,..#....#....#
#X.####...,#...,#...,#....#
#..####..,.#....#....#....#
###########################
      #....#               
      ######               
