[Main]
Name = Test Level
Start = 1, 1

[Objects]
Door = 2, 1
	3, 1
	4, 1

[Terrain]
poo =
           ######          
           #....#          
###########################
#..####....#.,..#....#....#
#X.####...,#...,#...,#....#
#..####..,.#....#....#....#
###########################
      #....#               
      ######               

terrain = 

#######
#.....#
#######
#,....#
#...__#
#..##X#
#######
