[Main]
Name = Test Level
Start = 12, 11

[Objects]
Door = 12, 12
	12, 10
	11, 11
	13, 11
	8, 14
	3, 16
	2, 16
	2, 9
	12, 4
	7, 8
	12, 14

[Terrain]

terrain = 

#######################
#....#...#.....#......#
#....#...#.....#......#
#....#...#.....#......#
#....#,..#,....#,.....#
#....#...#.....#......#
#....#...#.....#......#
#....#######_###......#
#....#...#.....#,.....#
#....#...#######......#
#....######...##._____#
#....##.,#.....#.####X#
###########...##._____#
#...,#...###_###......#
#....#...##....#,.....#
#....#...#######......#
#...,#,..#.....#......#
#....#...#.....#......#
##########.....#......#
#.,.._...#.....#......#
#...._...#,....#......#
#...._...#.....#,.....#
#######################
